--OOO--------
-OOCO--------
-OOOU-P--S---
-OOO---------
-------------
-----S---S---
-------------
---XRXX------
---XXXR------
---XXXR---MWT